11111111111
10000C00101
1P10C000T01
11010011101
11010001101
10CC0CC1101
10E000C1101
11111111111