1111111111
10000C0011
1P10C00001
1101011111
1101000111
10CC000111
10E000C111
1111111111