1111111111
1000000P11
1010C00001
1101011111
1101000111
1C00CC0111
10E00C0111
1111111111